# # # # #
~ ~ # ~ #
~ # # $ #
# $ # # #
# # # # #
~ # # # #
~ # # ~ ~
# # ~ # #
# ~ # $ #
~ ~ # # P