~ # # # $ # 
# # P # # # 
# # ~ ~ ~ # 
# # # # # # 
$ # # # ~ ~ 
# ~ # ~ # # 
~ # # ~ ~ # 
~ # # ~ # # 
~ $ # # # ~ 
# # $ # # # 