! # ^ # # # # # #
^ # # ~ # ^ ! ~ ~
# # ^ # ~ ^ ~ ~ #
~ # ! ^ ~ # ~ ~ ~
! ! ^ # P # # # #
~ # # ! # # ! # ^
~ ^ ! # # # ! ~ #
~ ! ^ # # # # # #
# ^ ^ # ~ # # # #
